111111111111111111111111111111
1E0001000000000000000001000001
100001001111110000001111100001
100000000000000000000000110111
100000001111111111111000000001
100000001C00000000000000000001
111111111111111111111000000001
100000000000000000000000111111
1000000010000000011110000000P1
111111111111111111111111111111