WE assets/image/sprites/west_sprite.xpm
EA assets/image/sprites/east_sprite.xpm
SO assets/image/sprites/south_sprite.xpm
NO assets/image/sprites/nord_sprite.xpm


C 225,30,0
F 220,100,0

        111111111111111111111111
        100000000011000000000001
        1011000001110000000000011
        100100000000000000W0001
111111111011000001110000000000111
100000000011000001110111111111111111
11110111111111111011100000010111
11110111111111011101010010001
11000000110101011100000010001
10000000000000001100000010001
10000000000000001101010010001
1100000111010101111101111000111
11110111 1110101 101111010001
11111111 1111111 111111111111