WE ./assets/image/sprites/west_sprite.xpm
EA ./assets/image/sprites/diff.xpm
SO ./assets/image/sprites/bob.xpm
NO ./assets/image/sprites/nord_sprite.xpm

F 110,110,100
C 0,0,0

        1111111111111111111111111
        1000000000110000000000001
        1011000001110000000000001
        1001000000d00000000000001
1111111110110000011100000000W0001
100000000011000001110111111111111
11110111111111011100000010001
1111d111111111011101010010001
11110111110101011100000010001
10000000000000001100000010001
10000000000000001101010010001
11000001110101011111011110001111
11110111 1110101 101111010001
11111111 1111111 111111111111