111111111111111111111111111111
1P00010000000000000000010C0001
100001001111110000001111100001
100000000000000000000000110111
100000001111111110011000000001
100000001C00000000001000000001
111011111111111111111000001001
100000000000000000000000111111
100C000010000000011110000000E1
111111111111111111111111111111