111111111111111111111111111111
1000010000000000000000010C0001
100010011111100000011111000001
100000000000000000000000110111
1000000011111111100110000P0001
100000001C00000000001000000001
111011111111111111111000001001
100000000000000000000000111111
100C000010000000011110000000E1
111111111111111111111111111111