11111111111111111111111111111111111
1P000000000000000000000000000000001
100C1000000000000000000000000000001
10001000000000000000000000000000001
10E01000000000000000000000000000001
10001000000000000000000000000000001
11111111111111111111111111111111111